Month_number,Apple,Melon,Mandarin,Strawberry,Total
1,10,2,10,5,27
2,10,2,15,10,37
3,10,2,10,15,37
4,10,4,5,15,34
5,10,8,2,5,25
6,10,15,2,3,30
7,10,20,2,2,34
8,10,30,3,2,45
9,10,10,5,2,27
10,10,5,10,2,27
11,10,2,30,2,44
12,10,2,20,2,34